aceleramos	aceleramos
actuamos	actuamos
administramos	administramos
analizamos	analizamos
aparecemos	aparecimos
aprovechamos	aprovechamos
atendemos	atendimos
comemos	comimos
confiamos	confiamos
conseguimos	conseguimos
consolidamos	consolidamos
consultamos	consultamos
controlamos	controlamos
cumplimos	cumplimos
decimos	dijimos
descargamos	descargamos
descubrimos	descubrimos
desempeñamos	desempeñamos
enfrentamos	enfrentamos
establecemos	establecimos
evadimos	evadimos
expresamos	expresamos
formamos	formamos
formulamos	formulamos
hemos	hubimos
impedimos	impedimos
incluimos	incluimos
iniciamos	iniciamos
integramos	integramos
vamos	fuimos
limpiamos	limpiamos
mencionamos	mencionamos
necesitamos	necesitamos
pagamos	pagamos
perdemos	perdimos
permanecemos	permanecimos
ponemos	pusimos
preguntamos	preguntamos
producimos	produjimos
proponemos	propusimos
reforzamos	reforzamos
representamos	representamos
requerimos	requerimos
satisfacemos	satisficimos
sentimos	sentimos
sugerimos	sugerimos
sumamos	sumamos
tomamos	tomamos
viajamos	viajamos
votamos	votamos
